++++++++++++++++++++++
+   +   ++ ++        +
      +     ++++++++++
+ +    ++  ++++ +++ ++
+ +   + + ++    +++  +
+          ++  ++  + +
+++++ + +     S++  + +
+++++ +++  + +  ++   +
+          + + ++ +  +
+++++ +  + + + ++  + +
++++++++++++++++++++++
